#####
#   #
#.$@#
#####

; Basic

#####
#   #
#.$@#
#.$ #
#.$ #
#####

; Basic meduim